#########
### @ ###
### * ###
#  ...  #
# ##$## #
# $   $ #
###   ###
###   ###
#########