#########
###   ###
# . $ . #
# #.$.# #
# $ # $ #
### @ ###
#########