PPPPPPPP
PPPVVOVP
PPVXVPVP
PPVOCVVP
PPVVPCPP
PPPVAVPP
PPPPPPPP
PPPPPPPP
