PPPPPPPP
PPOPPPOP
PPVPVVOP
PPVCCVAP
PPVVCVVP
PPVVPVVP
PPVVPPPP
PPPPPPPP
