#########
###   ###
###.#   #
# $.$ # #
# #* $  #
#@ . ####
#########