PPPPPPPP
PPPPVAPP
PVVXCVPP
PVVVVVPP
PPVOPPPP
PPCVPPPP
PPVOPPPP
PPPPPPPP
