#########
###  . ##
## * # ##
## .$  ##
##  #$###
### @ ###
#########