#########
## @ ####
## .   ##
#. $.$ ##
##$# ####
##   ####
#########
#########