PPPPPPPP
PPVVOAVP
PPVPOPVP
PPVVVCVP
PPOCCVPP
PPVVPPPP
PPPPPPPP
PPPPPPPP
